322222222222222222223
200000000000000000002
200000000000000000002
200000000000000000002
200000000000000000002
200000000000000000002
200000222222222000002
200000200000000000002
200000200000000000002
200000000111000000002
200000000000002000002
200000000000002000002
200000222222222000002
200000000000000000002
200000000000000000002
200000000000000000002
200000000000000000002
200000000000000000002
200000000000000000002
200000000000000000002
322222222222222222223
400
15
3
2