322222222232222222223
200000000020000000002
200000000020000000002
200000000020000000002
200000000000000000002
200002220000022200002
200000000000000000002
200222000000000222002
200000000000000000002
322200000111000002223
200000000000000000002
200222000000000222002
200000000000000000002
200002220000022200002
200000000000000000002
200000022202220000002
200000000000000000002
200000000020000000002
200000000020000000002
200000000020000000002
322222222232222222223
300
30
3
3