322222222222222222223
200000000000000000002
202220222022202220223
200000000000000000002
202022202220222022202
200000000000000000002
322202220222022202202
200000000000000000002
302220222022202220223
200000000000000000002
320222000111000222023
200000000000000000002
202022202220222022202
200000000000000000002
322202220222022202202
200000000000000000002
202220222022202220223
200000000000000000002
200222022202220222002
200000000000000000002
322222222222222222223
350
30
3
2